WIDTH 21
HEIGHT 18
*********************
*S                  *
** ** *  *          *
** MM           **  *
** *            *****
** ****             *
**    ** *** *      *
**    ** *** *      *
**    ** *** *      *
**    ** *** *      *
**    ** *** *      *
**    ** *** *      *
**    ** *** *      *
**    ** *** ********
**    *            G*
** ** *  *          *
** **    *          *
*********************
